1110001110001110000
0010001010001010000
0011111011111011110
0000000000000000010
0111111111111111110
0100000000000000000
0111111111111111110
0000000000000000010
0000000000000000011