1111111111111111110
0000000000000000010
0111111111111111110
0100000000000000000
0111111111111111110
0000000000000000010
0111111111111111110
0100000000000000000
0111111111111111111