0000000000000000000
1111111111111111111
1000000000000000001
1002222222222220001
1002000000000020001
1002222222222220001
1000000000000000001
1111111111111111111
0000000000000000000